111111111111111111111111
100C000P000E000000000001
100000000000000000000001
100C00000000000000000001
100000000000000000000001
100C00000000000000000001
111111111111111111111111