11111111111111111
1CPCC000000000111
1C000100111111111
11110011000M00111
1E000000010010001
11111111111111111