11111111111111
100000P00C0E01
11111111111111