111111111111111111
1CPCC0000000001111
1C0001001111111111
10000M000EC0M01111
1C000M00110MM01111
111111111111111111