11111111111111111
1CPCC000000000111
1C000100111111111
1000000000C000111
1C000100111111111
1C000000110000101
10000000000000001
11111111000000111
1E000000010010001
11111111111111111