11111111111111
100M00P00C0E01
11111111111111