111111111111111111
1CPCC0000000001111
1C0001001111111111
100M00000EC0001111
1C0000001100001111
111111111111111111