11111111111111111
1CPCC000000000111
1C000100111111111
1000MMM000C000111
1C000100111111111
1C00M0001100M0101
1000M000000000001
11111111000000111
1E000000010010001
11111111111111111