111111111111111111111
1P0000CCC011100000001
100001000000010011111
10001110000000C00C001
100000CCC011100000001
100001000000010011101
10001110000000C01C0E1
111111111111111111111