111111111111111
1CP000000000E01
111111111111111